1000 PRINT"BBBBBB B B BBBBBBBBBB B B BBBBBB";
1001 PRINT"B    BBBBBBB        BBBBBBB    B";
1002 PRINT"B    BBBBBBB        BBBBBBB    B";
1003 PRINT"B    BBBBBBB        BBBBBBB    B";
1004 PRINT"B    BBBBBBBBBBBBBBBBBBBBBB    B";
1005 PRINT"B    BBBBBBBBBBBBBBBBBBBBBB    B";
1006 PRINT"B       BBBBBBBBBBBBBBBB       B";
1007 PRINT"B       BBBBBB    BBBBBB       B";
1008 PRINT"B       BBBBBB    BBBBBB       B";
1009 PRINT"B       BBBBBB    BBBBBB       B";
1010 PRINT"B                              B";
1011 PRINT"B                              B";
1012 PRINT"B                              B";
1013 PRINT"B                              B";
1014 PRINT"BBBBBBBBBBBB         BBBBBBBBBBB";
1015 REM
1100 PRINT"                                ";
1101 PRINT"                                ";
1102 PRINT"                                ";
1103 PRINT"                                ";
1104 PRINT"                                ";
1105 PRINT"                                ";
1106 PRINT"                                ";
1107 PRINT"                                ";
1108 PRINT"                                ";
1109 PRINT"                                ";
1110 PRINT"                                ";
1111 PRINT"                                ";
1112 PRINT"                                ";
1113 PRINT"                                ";
1114 PRINT"                                ";
1115 REM
1200 PRINT"                                ";
1201 PRINT"                                ";
1202 PRINT"                                ";
1203 PRINT"                                ";
1204 PRINT"                                ";
1205 PRINT"                                ";
1206 PRINT"                                ";
1207 PRINT"                                ";
1208 PRINT"                                ";
1209 PRINT"                                ";
1210 PRINT"                                ";
1211 PRINT"                                ";
1212 PRINT"                                ";
1213 PRINT"                                ";
1214 PRINT"                                ";
1215 REM
1300 PRINT"                                ";
1301 PRINT"                                ";
1302 PRINT"                                ";
1303 PRINT"                                ";
1304 PRINT"                                ";
1305 PRINT"                                ";
1306 PRINT"                                ";
1307 PRINT"                                ";
1308 PRINT"                                ";
1309 PRINT"                                ";
1310 PRINT"                                ";
1311 PRINT"                                ";
1312 PRINT"                                ";
1313 PRINT"                                ";
1314 PRINT"                                ";
1315 REM
1400 PRINT"                                ";
1401 PRINT"                                ";
1402 PRINT"                                ";
1403 PRINT"                                ";
1404 PRINT"                                ";
1405 PRINT"                                ";
1406 PRINT"                                ";
1407 PRINT"                                ";
1408 PRINT"                                ";
1409 PRINT"                                ";
1410 PRINT"                                ";
1411 PRINT"                                ";
1412 PRINT"                                ";
1413 PRINT"                                ";
1414 PRINT"                                ";
1415 REM
1500 PRINT"                                ";
1501 PRINT"                                ";
1502 PRINT"                                ";
1503 PRINT"                                ";
1504 PRINT"                                ";
1505 PRINT"                                ";
1506 PRINT"                                ";
1507 PRINT"                                ";
1508 PRINT"                                ";
1509 PRINT"                                ";
1510 PRINT"                                ";
1511 PRINT"                                ";
1512 PRINT"                                ";
1513 PRINT"                                ";
1514 PRINT"                                ";
1515 REM
1600 PRINT"                                ";
1601 PRINT"                                ";
1602 PRINT"                                ";
1603 PRINT"                                ";
1604 PRINT"                                ";
1605 PRINT"                                ";
1606 PRINT"                                ";
1607 PRINT"                                ";
1608 PRINT"                                ";
1609 PRINT"                                ";
1610 PRINT"                                ";
1611 PRINT"                                ";
1612 PRINT"                                ";
1613 PRINT"                                ";
1614 PRINT"                                ";
1615 REM
1700 PRINT"                                ";
1701 PRINT"                                ";
1702 PRINT"                                ";
1703 PRINT"                                ";
1704 PRINT"                                ";
1705 PRINT"                                ";
1706 PRINT"                                ";
1707 PRINT"                                ";
1708 PRINT"                                ";
1709 PRINT"                                ";
1710 PRINT"                                ";
1711 PRINT"                                ";
1712 PRINT"                                ";
1713 PRINT"                                ";
1714 PRINT"                                ";
1715 REM
1800 PRINT"                                ";
1801 PRINT"                                ";
1802 PRINT"                                ";
1803 PRINT"                                ";
1804 PRINT"                                ";
1805 PRINT"                                ";
1806 PRINT"                                ";
1807 PRINT"                                ";
1808 PRINT"                                ";
1809 PRINT"                                ";
1810 PRINT"                                ";
1811 PRINT"                                ";
1812 PRINT"                                ";
1813 PRINT"                                ";
1814 PRINT"                                ";
1815 REM
1900 PRINT"                                ";
1901 PRINT"                                ";
1902 PRINT"                                ";
1903 PRINT"                                ";
1904 PRINT"                                ";
1905 PRINT"                                ";
1906 PRINT"                                ";
1907 PRINT"                                ";
1908 PRINT"                                ";
1909 PRINT"                                ";
1910 PRINT"                                ";
1911 PRINT"                                ";
1912 PRINT"                                ";
1913 PRINT"                                ";
1914 PRINT"                                ";
2000 PRINT"                                ";
2001 PRINT"                                ";
2002 PRINT"                                ";
2003 PRINT"                                ";
2004 PRINT"                                ";
2005 PRINT"                                ";
2006 PRINT"                                ";
2007 PRINT"                                ";
2008 PRINT"                                ";
2009 PRINT"                                ";
2010 PRINT"                                ";
2011 PRINT"                                ";
2012 PRINT"                                ";
2013 PRINT"                                ";
2014 PRINT"                                ";
2015 REM
2100 PRINT"                                ";
2101 PRINT"                                ";
2102 PRINT"                                ";
2103 PRINT"                                ";
2104 PRINT"                                ";
2105 PRINT"                                ";
2106 PRINT"                                ";
2107 PRINT"                                ";
2108 PRINT"                                ";
2109 PRINT"                                ";
2110 PRINT"                                ";
2111 PRINT"                                ";
2112 PRINT"                                ";
2113 PRINT"                                ";
2114 PRINT"                                ";
2115 REM
2200 PRINT"                                ";
2201 PRINT"                                ";
2202 PRINT"                                ";
2203 PRINT"                                ";
2204 PRINT"                                ";
2205 PRINT"                                ";
2206 PRINT"                                ";
2207 PRINT"                                ";
2208 PRINT"                                ";
2209 PRINT"                                ";
2210 PRINT"                                ";
2211 PRINT"                                ";
2212 PRINT"                                ";
2213 PRINT"                                ";
2214 PRINT"                                ";
2215 REM
2300 PRINT"                                ";
2301 PRINT"                                ";
2302 PRINT"                                ";
2303 PRINT"                                ";
2304 PRINT"                                ";
2305 PRINT"                                ";
2306 PRINT"                                ";
2307 PRINT"                                ";
2308 PRINT"                                ";
2309 PRINT"                                ";
2310 PRINT"                                ";
2311 PRINT"                                ";
2312 PRINT"                                ";
2313 PRINT"                                ";
2314 PRINT"                                ";
2315 REM
2400 PRINT"                                ";
2401 PRINT"                                ";
2402 PRINT"                                ";
2403 PRINT"                                ";
2404 PRINT"                                ";
2405 PRINT"                                ";
2406 PRINT"                                ";
2407 PRINT"                                ";
2408 PRINT"                                ";
2409 PRINT"                                ";
2410 PRINT"                                ";
2411 PRINT"                                ";
2412 PRINT"                                ";
2413 PRINT"                                ";
2414 PRINT"                                ";
2415 REM
2500 PRINT"                                ";
2501 PRINT"                                ";
2502 PRINT"                                ";
2503 PRINT"                                ";
2504 PRINT"                                ";
2505 PRINT"                                ";
2506 PRINT"                                ";
2507 PRINT"                                ";
2508 PRINT"                                ";
2509 PRINT"                                ";
2510 PRINT"                                ";
2511 PRINT"                                ";
2512 PRINT"                                ";
2513 PRINT"                                ";
2514 PRINT"                                ";
2515 REM
2600 PRINT"                                ";
2601 PRINT"                                ";
2602 PRINT"                                ";
2603 PRINT"                                ";
2604 PRINT"                                ";
2605 PRINT"                                ";
2606 PRINT"                                ";
2607 PRINT"                                ";
2608 PRINT"                                ";
2609 PRINT"                                ";
2610 PRINT"                                ";
2611 PRINT"                                ";
2612 PRINT"                                ";
2613 PRINT"                                ";
2614 PRINT"                                ";
2615 REM
2700 PRINT"                                ";
2701 PRINT"                                ";
2702 PRINT"                                ";
2703 PRINT"                                ";
2704 PRINT"                                ";
2705 PRINT"                                ";
2706 PRINT"                                ";
2707 PRINT"                                ";
2708 PRINT"                                ";
2709 PRINT"                                ";
2710 PRINT"                                ";
2711 PRINT"                                ";
2712 PRINT"                                ";
2713 PRINT"                                ";
2714 PRINT"                                ";
2715 REM
2800 PRINT"                                ";
2801 PRINT"                                ";
2802 PRINT"                                ";
2803 PRINT"                                ";
2804 PRINT"                                ";
2805 PRINT"                                ";
2806 PRINT"                                ";
2807 PRINT"                                ";
2808 PRINT"                                ";
2809 PRINT"                                ";
2810 PRINT"                                ";
2811 PRINT"                                ";
2812 PRINT"                                ";
2813 PRINT"                                ";
2814 PRINT"                                ";
2815 REM
2900 PRINT"                                ";
2901 PRINT"                                ";
2902 PRINT"                                ";
2903 PRINT"                                ";
2904 PRINT"                                ";
2905 PRINT"                                ";
2906 PRINT"                                ";
2907 PRINT"                                ";
2908 PRINT"                                ";
2909 PRINT"                                ";
2910 PRINT"                                ";
2911 PRINT"                                ";
2912 PRINT"                                ";
2913 PRINT"                                ";
2914 PRINT"                                ";
