™•€€€€…€€€ωψρωπόφψσωςφφςϊςϊ
›—€€€€€€€ππ€€€€€€€€€€ψ€ψττ€
€€€€€€€€€€€€€€€€€€€€€€€€€€€€€€€
“•€€€€ƒ…€€€€½·€€€€€€€€€€€€€€€
›—€€€€€‡€€€€°€€€€€€€€€€€€€€€€
€€€€€€€€€€€€€€€€€€€€€€€€€€€€€€€€
Ξ€Ύ€€€¦©ΰ€€€€€›€€€€€€€€€€€€€€€
ΐ€€€€€€ª¥€€€€€€—’€€€€€€€€€€€€€€€
ΓΞΚ€€€€€€€€€€€€€€€€€€€€€€€€€€€€
ΘΜΘ€€€€€€€€€€€€€€€€€€€€€€€€€€€€€
³ΎΊ€€ΰνΰξ€€€€€€€€€€€€€€€€€€€€€€
ΈΌΈ€€€ΰηΰλ€€€€€€€€€€€€€€€€€€€€€€
“€€€€€€€€€€€€€€€€€€€€€€€€€€€€€
€€€€€€€€€€€€€€€€€€€€€€€€€€€€€
€€€€€€€€€€€€€€€€€€€€€€€€€€€€€€€€
€€€€€€€€€€€€€€€€€€€€€€€€€€€€€€€€
