10 CLS0:GOTO9000
8000 I$=INKEY$:IFI$=""THEN8000
8020 CLS0:RETURN
9000 PRINT"ÐÜßßßßßßßßßßßßßßßßßßßßßßßßßßßßÜÐ";
9001 PRINT"ÐÐÐÜßßßßßßßßßßßßßßßßßßßßßßßßÜÐÐÐ";
9002 PRINT"ÐÐÐÐÐÜßßßßßßßßßßßßßßßßßßßßÜÐÐÐÐÐ";
9003 PRINT"ÐÐÐÐÐÐÐÜÜßßßßßßßßßßßßßßÜÜÐÐÐÐÐÐÐ";
9004 PRINT"ÐÐÐÐÐÐÐÐÐÐÐÐÜÜÜÜÜÜÜÜÐÐÐÐÐÐÐÐÐÐÐÐ";
9005 PRINT"ÐÐÐÐÐÐÐÐÐÐÐÐÐÐÐÐÐÐÐÐÐÐÐÐÐÐÐÐÐÐÐÐ";
9006 PRINT"ÐÐÐÐÐÐÐÐÐÐÐÐÐÐÐÐÐÐÐÐÐÐÐÐÐÐÐÐÐÐÐÐ";
9007 PRINT"ÐÐÐÐÐÐÐÐÐÐÐÐÐÐÐÐÐÐÐÐÐÐÐÐÐÐÐÐÐÐÐÐ";
9008 PRINT"ÐÐÐÐÐÐÐÐÐÐÐÐÐÐÐÐÐÐÐÐÐÐÐÐÐÐÐÐÐÐÐÐ";
9009 PRINT"ÐÐÐÐÐÐÐÐÐÐÐÐÐÐÐÐÐÐÐÐÐÐÐÐÐÐÐÐÐÐÐÐ";
9010 PRINT"ÐÐÐÐÐÐÐÐÐÐÐÐÐÐÐÐÐÐÐÐÐÐÐÐÐÐÐÐÐÐÐÐ";
9011 PRINT"ÐÐÐÐÐÐÐÐÐÐÐÐÓÓÓÓÓÓÓÓÐÐÐÐÐÐÐÐÐÐÐÐ";
9012 PRINT"ÐÐÐÐÐÐÐÓÓßßßßßßßßßßßßßßÓÓÐÐÐÐÐÐÐ";
9013 PRINT"ÐÐÐÐÐÓßßßßßßßßßßßßßßßßßßßßÓÐÐÐÐÐ";
9014 PRINT"ÐÐÐÓßßßßßßßßßßßßßßßßßßßßßßßßÓÐÐÐ";
9015 PRINT"ÐÓßßßßßßßßßßßßßßßßßßßßßßßßßßßßÓ";
9016 GOSUB8000
9100 PRINT"ÐÜßßßßßßßßßßßßßßßßßßßßßßßßßßßßÜÐ";
9101 PRINT"ÐÐÐÜßßßßßßßßßßßßßßßßßßßßßßßßÜÐÐÐ";
9102 PRINT"ÐÐÐÐÐÜßßßßßßßßßßßßßßßßßßßßÜÐÐÐÐÐ";
9103 PRINT"ÐÐÐÐÐÐÐÜÜÜÜÜÜÜÜÜÜÜÜÜÜÜÜÜÜÐÐÐÐÐÐÐ";
9104 PRINT"ÐÐÐÐÐÐÐÐßßßßßßßßßßßßßßßßÐÐÐÐÐÐÐÐ";
9105 PRINT"ÐÐÐÐÐÐÐÐßßßßßßßßßßßßßßßßÐÐÐÐÐÐÐÐ";
9106 PRINT"ÐÐÐÐÐÐÐÐßßßßßßßßßßßßßßßßÐÐÐÐÐÐÐÐ";
9107 PRINT"ÐÐÐÐÐÐÐÐßßßßßßßßßßßßßßßßÐÐÐÐÐÐÐÐ";
9108 PRINT"ÐÐÐÐÐÐÐÐßßßßßßßßßßßßßßßßÐÐÐÐÐÐÐÐ";
9109 PRINT"ÐÐÐÐÐÐÐÐßßßßßßßßßßßßßßßßÐÐÐÐÐÐÐÐ";
9110 PRINT"ÐÐÐÐÐÐÐÐßßßßßßßßßßßßßßßßÐÐÐÐÐÐÐÐ";
9111 PRINT"ÐÐÐÐÐÐÐÐßßßßßßßßßßßßßßßßÐÐÐÐÐÐÐÐ";
9112 PRINT"ÐÐÐÐÐÐÐÓÓÓÓÓÓÓÓÓÓÓÓÓÓÓÓÓÓÐÐÐÐÐÐÐ";
9113 PRINT"ÐÐÐÐÐÓßßßßßßßßßßßßßßßßßßßßÓÐÐÐÐÐ";
9114 PRINT"ÐÐÐÓßßßßßßßßßßßßßßßßßßßßßßßßÓÐÐÐ";
9115 PRINT"ÐÓßßßßßßßßßßßßßßßßßßßßßßßßßßßßÓ";
9116 GOSUB8000
9200 PRINT"ÓÜßßßßßßßßßßßßßßßßßßßßßßßßßßßßÜÐ";
9201 PRINT"ßßÓÜßßßßßßßßßßßßßßßßßßßßßßßßÜÐÐÐ";
9202 PRINT"ßßßßÓÜßßßßßßßßßßßßßßßßßßßßÜÐÐÐÐÐ";
9203 PRINT"ßßßßßßÓÜÜÜÜÜÜÜÜÜÜÜÜÜÜÜÜÜÜÐÐÐÐÐÐÐ";
9204 PRINT"ßßßßßßßÐßßßßßßßßßßßßßßßßÐÐÐÐÐÐÐÐ";
9205 PRINT"ßßßßßßßÐßßßßßßßßßßßßßßßßÐÐÐÐÐÐÐÐ";
9206 PRINT"ßßßßßßßÐßßßßßßßßßßßßßßßßÐÐÐÐÐÐÐÐ";
9207 PRINT"ßßßßßßßÐßßßßßßßßßßßßßßßßÐÐÐÐÐÐÐÐ";
9208 PRINT"ßßßßßßßÐßßßßßßßßßßßßßßßßÐÐÐÐÐÐÐÐ";
9209 PRINT"ßßßßßßßÐßßßßßßßßßßßßßßßßÐÐÐÐÐÐÐÐ";
9210 PRINT"ßßßßßßßÐßßßßßßßßßßßßßßßßÐÐÐÐÐÐÐÐ";
9211 PRINT"ßßßßßßßÐßßßßßßßßßßßßßßßßÐÐÐÐÐÐÐÐ";
9212 PRINT"ßßßßßßÜÓÓÓÓÓÓÓÓÓÓÓÓÓÓÓÓÓÓÐÐÐÐÐÐÐ";
9213 PRINT"ßßßßÜÓßßßßßßßßßßßßßßßßßßßßÓÐÐÐÐÐ";
9214 PRINT"ßßÜÓßßßßßßßßßßßßßßßßßßßßßßßßÓÐÐÐ";
9215 PRINT"ÜÓßßßßßßßßßßßßßßßßßßßßßßßßßßßßÓ";
9216 GOSUB8000
9300 PRINT"ÓÜßßßßßßßßßßßßßßßßßßßßßßßßßßßßÜÓ";
9301 PRINT"ßßÓÜßßßßßßßßßßßßßßßßßßßßßßßßÜÓßß";
9302 PRINT"ßßßßÓÜßßßßßßßßßßßßßßßßßßßßÜÓßßßß";
9303 PRINT"ßßßßßßÓÜÜÜÜÜÜÜÜÜÜÜÜÜÜÜÜÜÜÓßßßßßß";
9304 PRINT"ßßßßßßßÐßßßßßßßßßßßßßßßßÐßßßßßßß";
9305 PRINT"ßßßßßßßÐßßßßßßßßßßßßßßßßÐßßßßßßß";
9306 PRINT"ßßßßßßßÐßßßßßßßßßßßßßßßßÐßßßßßßß";
9307 PRINT"ßßßßßßßÐßßßßßßßßßßßßßßßßÐßßßßßßß";
9308 PRINT"ßßßßßßßÐßßßßßßßßßßßßßßßßÐßßßßßßß";
9309 PRINT"ßßßßßßßÐßßßßßßßßßßßßßßßßÐßßßßßßß";
9310 PRINT"ßßßßßßßÐßßßßßßßßßßßßßßßßÐßßßßßßß";
9311 PRINT"ßßßßßßßÐßßßßßßßßßßßßßßßßÐßßßßßßß";
9312 PRINT"ßßßßßßÜÓÓÓÓÓÓÓÓÓÓÓÓÓÓÓÓÓÓÜßßßßßß";
9313 PRINT"ßßßßÜÓßßßßßßßßßßßßßßßßßßßßÓÜßßßß";
9314 PRINT"ßßÜÓßßßßßßßßßßßßßßßßßßßßßßßßÓÜßß";
9315 PRINT"ÜÓßßßßßßßßßßßßßßßßßßßßßßßßßßßßÓ";
9316 GOSUB8000
9317 GOTO9317
9900 A$(1)="°°¿¿¿¿°°°"
9901 B$(1)="¿¿¿¿¿¿¿¿°"
9902 C$(1)="°°ÏÇËÏ°°Ï"
9903 D$(1)="°¿¿¿¿¿¿¿¿"
9904 E$(1)="°¿¿¿¿¿°°Ï"
9905 F$(1)="°¿¿¿¿¿°°Ï"
9906 G$(1)="°¿¿¿¿¿°°Ï"
9907 H$(1)="°°¿¿¿¿°°Ï"
9908 I$(1)="°°¿¿¿¿°°Ï"
9909 J$(1)="°°¿¿¿¿°°Ï"
9910 A$(2)="°°°ÏÏÏ°°°"
9911 B$(2)="°°Ï°Ï°Ï°°"
9912 C$(2)="°°ÏÏÏÏÏ°°"
9913 D$(2)="°°°Ï°Ï°°°"
9914 E$(2)="°Ï°°°°°Ï°"
9915 F$(2)="°Ï°ÏÏÏ°Ï°"
9916 G$(2)="Ï°°°Ï°°°Ï"
9917 H$(2)="ÏÏ°ÏÏÏ°ÏÏ"
9918 I$(2)="°°°Ï°Ï°°°"
9919 J$(2)="°°°Ï°Ï°°°"
9920 A$(3)="°ÿÿÿÿÿ°"
9921 B$(3)="ÿÿ°°°ÿÿ"
9922 C$(3)="°ÿÿ°ÿÿ°"
9923 D$(3)="°ÿÿÿÿÿ°"
9924 E$(3)="ÿÿÿÿÿÿÿ"
9925 F$(3)="ÿÿÿÿÿÿÿ"
9926 G$(3)="ÿÿÿÿÿÿÿ"
9927 H$(3)="ÿÿÿÿÿÿÿ"
9928 I$(3)="°ÿÿÿÿÿ°"
9929 J$(3)="°ÿÿ°ÿÿ°"
9930 A$(4)="Ÿ°     °"
9931 B$(4)="Ÿ° ° ° °"
9932 C$(4)="Ÿ°     °"
9933 D$(4)="Ÿ° °°° °"
9934 E$(4)="Ÿ° °    "
9935 F$(4)="   ° °° "
9936 G$(4)="   ° °° "
9937 H$(4)="°° ° °° "
9938 I$(4)="°° °    "
9939 J$(4)="°°  °  °"
9940 A$(5)="°°ï°°°°°°°°°°°ï°°"
9941 B$(5)="°ï°ï°°ïïïïï°°ï°ï°"
9942 C$(5)="°°°ïïïïïïïïïïï°°°"
9943 D$(5)="°ïïïïïïïïïïïïïïï°"
9944 E$(5)="ï°°ïïïïÏïÏïïïï°°ï"
9945 F$(5)="ï°ï°ï°ïïïïï°ï°ï°ï"
9946 G$(5)="ï°ï°ï°ï°°°ï°ï°ï°ï"
9947 H$(5)="°°ï°ï°°ï°ï°°ï°ï°°"
9948 I$(5)="°°ï°ï°°°°°°°ï°ï°°"
9949 J$(5)="°°°°ï°°°°°°°ï°°°°"
