120 DIMC(26,26):FORX=0TO25:FORY=0TO25:READC(X,Y):NEXTY,X:C(0,25)=5:C(0,26)=11:CSAVE*C,"LVL2DATA":END
128 CLS0:FORX=1TO25:FORY=0TO25:IFC(X,Y)THENSET(X,Y,1)
130 NEXT:NEXT:A=0:B=0
140 I$=INKEY$:C=POINT(A,B):RESET(A,B):SET(A,B,1):IFC=0THENRESET(A,B)
150 IFI$="A"THENA=A-1
160 IFI$="S"THENA=A+1
170 IFI$="W"THENB=B-1
180 IFI$="Z"THENB=B+1
190 PRINT@20,C(A,B);:PRINT@52,B;A;
200 GOTO140
1000 DATA2,0,0,0,0,0,0,0,0,0,0,0,0,0,0,0,0,0,0,0,0,0,0,0,0,0
1001 DATA0,0,0,0,0,0,0,0,0,0,0,0,0,0,0,0,0,0,0,0,0,0,0,0,0,0
1002 DATA0,0,0,0,0,0,0,0,0,0,0,0,0,0,0,0,0,0,0,0,1,1,1,1,0,5
1003 DATA0,0,5,0,5,0,5,0,5,0,5,0,0,1,1,1,2,1,0,0,1,0,0,1,0,5
1004 DATA0,0,5,0,5,0,5,0,5,0,5,0,0,1,0,1,0,1,0,0,1,0,0,1,0,1
1005 DATA0,0,1,1,1,1,1,1,1,1,1,2,1,1,0,1,0,1,0,0,1,0,0,1,0,1
1006 DATA0,0,5,0,5,0,5,0,5,0,5,0,5,0,0,1,0,0,0,1,1,5,0,1,0,1
1007 DATA0,0,5,0,5,0,5,0,5,0,5,0,5,0,0,1,0,5,0,1,0,0,0,1,0,1
1008 DATA0,0,0,0,0,0,0,0,0,0,0,0,0,0,0,1,1,1,1,1,0,0,0,1,2,1
1009 DATA0,0,0,0,0,0,0,0,0,0,0,0,0,0,0,0,0,0,0,0,0,0,0,1,0,0
1010 DATA0,0,5,0,1,2,1,2,1,1,1,1,0,1,1,1,1,1,1,0,1,1,1,1,0,4
1011 DATA0,0,1,2,1,0,1,0,0,1,0,1,0,0,2,0,0,0,1,0,1,0,2,0,0,1
1012 DATA0,0,0,0,1,0,0,0,1,1,0,1,1,0,1,1,1,0,1,1,1,0,1,0,0,1
1013 DATA0,0,5,0,1,2,1,0,1,0,0,0,1,0,0,0,1,0,0,0,0,0,0,0,0,1
1014 DATA0,0,1,2,1,0,5,0,1,0,0,0,1,1,0,0,1,0,5,1,1,1,2,1,1,1
1015 DATA0,0,0,0,1,0,0,0,1,1,1,0,0,1,0,1,1,0,1,0,0,0,0,0,0,1
1016 DATA0,0,5,0,1,2,1,0,0,0,1,0,0,1,0,0,1,0,1,0,0,0,0,0,0,2
1017 DATA0,0,1,2,1,0,5,0,1,1,1,0,1,1,1,2,1,0,1,0,0,0,0,0,0,1
1018 DATA0,0,0,0,1,0,0,0,1,0,0,0,0,0,0,0,0,0,1,0,0,1,1,1,1,1
1019 DATA0,0,3,0,1,0,0,0,1,1,1,2,1,1,1,1,2,1,1,0,0,1,0,1,0,1
1020 DATA0,0,1,0,1,0,0,0,0,0,0,0,0,0,0,0,0,0,0,0,0,1,0,2,0,0
1021 DATA0,0,1,1,1,1,1,1,1,1,1,2,1,1,1,1,1,1,1,1,1,1,0,1,0,0
1022 DATA0,0,0,1,0,1,0,1,0,5,0,0,0,0,0,0,1,0,0,0,0,0,0,1,1,0
1023 DATA0,0,0,1,0,2,0,5,0,1,0,0,0,5,0,0,1,1,1,2,1,0,0,0,1,0
1024 DATA0,0,0,1,1,1,1,1,1,1,1,2,1,1,1,5,0,0,0,0,1,1,1,1,1,0
1025 DATA0,0,0,0,0,0,0,0,0,0,0,0,0,0,0,0,0,0,0,0,0,0,0,0,0,0
