
10 CLS0
20 FORY=0TO31:FORX=0TO39:READN
30 IFNTHENSET(X+10,Y,N)
40 NEXTX,Y
50 GOTO50
30010 DATA 0,0,0,0,0,0,0,0,0,0,0,0,0,0,0,0,0,0,2,2,2,2,0,0,0,0,0,0,0,0,0,0,0,0,0,0,0,0,0,0
30020 DATA 0,0,0,0,0,0,0,0,0,0,0,0,0,0,0,0,0,2,2,2,2,2,2,1,0,0,0,0,0,0,0,0,0,0,0,0,0,0,0,0
30030 DATA 0,0,0,0,0,0,0,0,0,5,5,5,0,0,5,0,2,2,2,1,4,2,2,2,2,5,0,0,0,5,5,0,0,0,0,0,0,0,0,0
30040 DATA 0,0,0,0,0,4,4,4,4,4,4,4,4,4,4,4,4,2,2,2,2,2,2,2,4,4,6,4,4,4,4,4,4,4,4,0,0,0,0,0
30050 DATA 0,0,0,0,4,6,4,4,4,4,4,4,4,4,4,4,4,2,2,2,2,2,2,2,4,4,4,4,4,4,4,4,4,4,6,4,5,0,0,0
30060 DATA 0,0,0,4,6,6,4,4,4,4,4,4,4,4,4,2,2,2,2,2,2,2,2,4,4,4,4,4,4,4,4,4,4,6,6,4,0,0,0,0
30070 DATA 0,0,6,4,6,4,4,4,4,4,4,4,4,4,4,5,2,2,2,2,2,2,2,2,2,4,4,4,4,4,4,4,4,4,4,4,6,4,0,0
30080 DATA 0,0,4,4,4,4,5,5,5,5,5,5,5,5,5,1,2,2,2,2,2,2,2,2,2,5,5,5,5,5,5,5,5,5,5,4,4,4,5,0
30090 DATA 0,0,4,4,4,5,0,0,0,0,0,0,0,0,2,2,2,2,2,2,2,2,2,2,2,2,2,0,0,0,0,0,0,0,5,5,4,4,4,0
30100 DATA 0,0,4,4,5,0,0,0,0,0,0,0,0,0,1,2,2,2,2,2,2,2,2,2,2,2,1,0,0,0,0,0,0,0,0,0,5,4,4,0
30110 DATA 0,0,4,4,0,0,0,0,0,0,0,0,0,0,1,2,2,2,2,1,1,2,2,2,2,1,2,0,0,0,0,0,0,0,0,0,5,4,4,0
30120 DATA 0,4,4,5,0,0,0,0,0,0,0,0,0,0,2,2,2,2,2,1,2,2,2,2,2,2,2,0,0,0,0,0,0,0,0,0,0,4,4,0
30130 DATA 0,5,4,5,0,0,0,0,0,0,0,0,0,0,2,2,2,2,2,2,1,2,2,2,2,2,2,0,0,0,0,0,0,0,0,0,0,4,4,0
30140 DATA 0,0,4,5,0,0,0,0,0,0,0,0,0,0,2,2,2,2,2,2,2,2,2,2,2,2,0,0,0,0,0,0,0,0,0,0,0,4,4,0
30150 DATA 0,0,4,5,0,0,0,0,0,0,0,0,0,2,2,2,2,2,2,2,1,2,2,2,2,2,2,0,0,0,0,0,0,0,0,0,0,4,5,0
30160 DATA 0,0,5,5,0,0,0,0,0,0,0,0,0,2,7,0,2,2,2,2,2,2,2,2,2,7,1,2,0,0,0,0,0,0,0,0,0,4,0,0
30170 DATA 0,0,0,4,0,0,0,0,0,0,0,0,2,2,1,7,7,2,2,2,2,2,2,2,7,8,2,2,0,0,0,0,0,0,0,0,0,4,0,0
30180 DATA 0,0,0,0,0,0,0,0,0,0,0,0,2,2,2,2,8,0,0,0,1,0,0,0,0,2,2,2,0,0,0,0,0,0,0,0,5,0,0,0
30190 DATA 0,0,0,0,0,0,0,0,0,0,0,0,0,1,2,2,2,1,2,2,2,2,2,2,2,2,2,0,0,0,0,0,0,0,0,0,0,0,0,0
30200 DATA 0,0,0,0,0,0,0,0,0,0,0,0,0,0,2,2,2,1,2,2,2,2,2,2,2,2,2,0,0,0,0,0,0,0,0,0,0,0,0,0
30210 DATA 0,0,0,0,0,0,0,0,0,0,0,0,0,0,2,2,2,2,1,2,2,2,0,2,2,6,1,0,0,0,0,0,0,0,0,0,0,0,0,0
30220 DATA 0,0,0,0,0,0,0,0,0,0,0,0,0,0,1,2,2,2,0,0,2,0,1,2,1,7,0,0,0,0,0,0,0,0,0,0,0,0,0,0
30230 DATA 0,0,0,0,0,0,0,0,0,0,0,0,0,0,0,7,6,2,2,0,2,1,2,1,8,2,0,0,0,0,0,0,0,0,0,0,0,0,0,0
30240 DATA 0,0,0,0,0,0,0,0,0,0,0,0,0,0,0,2,6,2,2,1,2,2,1,7,0,2,0,0,0,0,0,0,0,0,0,0,0,0,0,0
30250 DATA 0,0,0,0,0,0,0,0,0,0,0,0,0,0,0,2,0,7,2,2,2,2,6,7,2,2,0,0,0,0,0,0,0,0,0,0,0,0,0,0
30260 DATA 0,0,0,0,0,0,0,0,0,0,0,0,0,0,0,2,2,7,7,7,7,6,7,0,2,2,0,0,0,0,0,0,0,0,0,0,0,0,0,0
30270 DATA 0,0,0,0,0,0,0,0,0,0,0,0,0,0,0,2,2,7,8,8,0,7,7,2,2,2,0,0,0,0,0,0,0,0,0,0,0,0,0,0
30280 DATA 0,0,0,0,0,0,0,0,0,0,0,0,0,0,0,1,2,2,7,7,7,7,7,2,2,0,0,0,0,0,0,0,0,0,0,0,0,0,0,0
30290 DATA 0,0,0,0,0,0,0,0,0,0,0,0,0,0,0,0,2,2,7,7,7,7,7,2,2,0,0,0,0,0,0,0,0,0,0,0,0,0,0,0
30300 DATA 0,0,0,0,0,0,0,0,0,0,0,0,0,0,0,0,2,2,7,7,7,7,2,1,0,0,0,0,0,0,0,0,0,0,0,0,0,0,0,0
30310 DATA 0,0,0,0,0,0,0,0,0,0,0,0,0,0,0,0,0,1,8,7,7,8,2,2,0,0,0,0,0,0,0,0,0,0,0,0,0,0,0,0
30320 DATA 0,0,0,0,0,0,0,0,0,0,0,0,0,0,0,0,1,1,1,8,1,5,8,8,0,0,0,0,0,0,0,0,0,0,0,0,0,0,0,0
