AAAAAEEDDNPPLAAAIAAJAACIAAAAAAAA
AAAAGEADABPPKAABAAAJAAPEMAEAAAAA
MMEJPMIMKBPLCAAEMIAONPPPPPMPOMMA
PPPMPPCEDFLAMAANHONPPPPPPPPPPPPC
LHPOPOAPOACAAEBHBPPPPPPPPPPLDFAA
ABPPPPOPPIAAAGOONPPPPPPPPPPOABAA
AAPPPPJPDBAAAMLLPDHHHPPPPPPLIAAA
AAPPPPPCAAAAADABBDPNPPPPPPHAKAAA
AAFPPLLAAAAAANPOMMPHPPPPPPIBAAAA
AAAHPAEAAAAAEPPPPPHOJHPPPLCAAAAA
